350070080
204000005
000000100
400007020
006592300
070300006
003000000
700000904
020050031