030000057
702000008
000306000
094005080
008010700
070800920
000502000
200000509
650000040